*************************************************************************************************************************
   *     *              *           *     *        *        *  *     *           *           *           *     *        *
*  *  *  *  ****  ****  *  *******  *  *  *  ****  *  ****  *  *  *  *  *******  *  *******  *  **********  *  *  ****  *
*  *  *  *  *     *     *        *     *  *  *     *     *        *  *     *     *  *           *        *  *     *     *
*  *  *  *  *******  **********  *******  *  *  *******  **********  ****  *  *  *  *  **********  ****  *  *  **********
*     *  *     *  *  *        *  *        *  *  *  *     *           *     *  *     *     *        *     *  *  *  *     *
*******  ****  *  *  *  ****  *  *  ****  *  *  *  *  ****  **********  ****************  *  *******  ****  *  *  *  *  *
*        *        *        *  *  *     *  *  *     *  *                 *              *  *  *     *        *  *  *  *  *
*  *******  **********  *  *  *  ****  ****  *  ****  ****  *************  *******  *  *  *  *  *************  *  *  *  *
*  *        *        *  *  *     *     *     *     *     *  *     *        *     *  *  *  *  *        *  *     *     *  *
*  *  *******  ****  ****  *******  ****  *******  ****  *  *  *  *  **********  *  ****  *  *  ****  *  *  *******  *  *
*     *        *  *        *     *     *  *     *     *  *  *  *  *     *        *        *  *     *  *           *  *  *
**********  ****  **********  *******  *  *  *  ****  *  *  *  *******  *  ****  **********  ****  *  **********  *  *  *
*           *     *  *     *     *     *  *  *  *     *  *  *        *     *  *     Y        *     *  *     *     *  *  *
*  **********  *  *  *  *  ****  *  ****  *  *  *  ****  *  *******  *******  **********  ****  ****  *  *  *  ****  *  *
*  *           *  *     *  *  *     *     *  *  *  *     *  *              *  *        *  *     *     *  *  *        *  *
*  *  ****  ****  *******  *  *******  ****  *  *  *  ****  *******  *  *  *  *  ****  *  *  **********  *************  *
*  *  *     *  *        *        *     *     *  *        *           *  *     *     *     *        *                    *
*  *  *  ****  *******  ****  *  *  ****  *  *  ****  ****************  **********  *************  *  *  ****************
*     *  *  *        *     *  *     *  *  *  *     *  *              *  *        *  *           *     *     *  *     *  *
*******  *  *******  ****  ****  ****  *  *******  *  *  **********  *  *  ****  *  **********  *  *******  *  *  *  *  *
*  *        *           *  *           *  *     *  *  *        *     *        *  *  *     *  *  *        *  *     *  *  *
*  *  *  ****  *******  *  *  **********  *  ****  *  *******  *  **********  *  *  *  *  *  *  ****  *  *  ****  *  *  *
*     *  *     *     *  *     *           *     *  *     *     *              *  *     *     *  *     *  *     *  *  *  *
*******  *******  *  *  *******  *************  *  *  *  **********************  **********  *  *  **********  *  *  *  *
*     *           *  *  *     *  *           *  *  *  *                          *        *     *     *        *  *  *  *
*  *  **********  *  *  *  *  *  ****  ****  *  *  *  *************************  *  ****  *************  *******  *  *  *
*  *           *  *     *  *  *  *     *     *     *  *     *     *           *  *  *  *  *                    *  *     *
*  *******  ****  *******  *  *  *  **********  ****  *  ****  *  **********  *  *  *  *  *  **********  ****  *******  *
*        *     *           *  *     *           *     *        *        *     *  *  *     *           *  *  *        *  *
*******  *  *  **********************  *  *******  *******************  *  ****  *  ****  **********  *  *  *******  *  *
*     *  *  *  *        *     *        *     *     *     *     *  *     *     *  *  *                 *     *     *  *  *
*  *  *  *  *  *  ****  *  *  *************  *  *******  *  *  *  *  *******  ****  *  *******  *******  ****  *  ****  *
*  *  *  *  *  *  *  *     *                    *        *  *  *  *  *     *        *        *  *     *  *     *     *  *
*  ****  *  *  *  *  ****************************  *******  *  *  *  *  *  *******************  *  *  *  *  *******  *  *
*     *  *  *     *        *     *     *        *  *  *     *     *     *                    *  *  *        *        *  *
****  *  *  ****  *  ****  *  *  *  *  *  ****  *  *  *  *  *************  ****************  *  *  **********  *  ****  *
*     *  *  *  *     *  *     *  *  *     *  *  *  *     *        *        *           *  *     *     *        *  *     *
*  ****  *  *  ****  *  *******  *******  *  *  *  **********  *  ****  *************  *  *******  ****  *  ****  *  ****
*     *  *     *     *  *     *           *     *  *        *  *     *              *  *           *     *  *  *     *  *
*  ****  *******  *  *  *  *  **********  *  ****  *  ****  *  ****  *  ****  ****  *  *************  ****  *  *******  *
*        *        *     *  *              *     *     *  *  *  *        *        *  *        *           *     *     *  *
**********  *************  *******************  *******  *  ****  *******  *******  ****  *  *  ****************  *  *  *
*     *     *     *     *        *     *  *     *        *     *     *  *  *     *     *  *  *           *        *  *  *
*  ****  *******  ****  *******  *  *  *  *  ****  *******  *  ****  *  *  *  *  ****  ****  **********  *  *  ****  *  *
*     *        *           *     *  *  *  *        *        *     *  *  *     *     *     *        *     *  *  *     *  *
*  *  ****  *  **********  *  *******  *  *************  *******  *  *  **********  ****  *******  *  ****  *  *  ****  *
*  *        *              *           *                 *           *              *              *        *  *        B 
*************************************************************************************************************************