##############################
##############################
##############################
                  ############
##### ########### ############
##### ########### ############
##### ########### ############
#####           # ############
################# ############
######            ############
###### ########## ############
###### #### ##### ############
###### #### #####             
######      ##################
##############################
