##############################
##############################
##############################
S                 ############
##### ########### ############
##### ########### ############
##### ########### ############
#####           # ############
################# ############
######            ############
###### ########## ############
###### #### ##### ############
###### #### #####            E
######      ##################
##############################
